{
"map" : [[1, 1, 2, 2, 2, 2, 2, 2, 2, 2, 2, 2, 2, 2, 2, 2, 2, 2, 2, 2, 2, 2, 2, 1, 1],
          [1, 1, 1, 2, 2, 2, 2, 2, 1, 2, 2, 5, 5, 5, 2, 2, 1, 2, 2, 2, 2, 2, 1, 1, 1],
          [2, 1, 1, 1, 2, 2, 2, 1, 1, 1, 2, 5, 8, 5, 2, 1, 1, 1, 2, 2, 2, 1, 1, 1, 2],
          [2, 2, 1, 1, 1, 2, 2, 2, 1, 2, 2, 5, 5, 5, 2, 2, 1, 2, 2, 2, 1, 1, 1, 2, 2],
          [2, 2, 2, 1, 2, 2, 2, 2, 2, 2, 2, 2, 2, 2, 2, 2, 2, 2, 2, 2, 2, 1, 2, 2, 2],
          [2, 2, 2, 2, 2, 2, 1, 2, 2, 2, 2, 2, 2, 2, 2, 2, 2, 2, 1, 2, 2, 2, 2, 2, 2],
          [2, 2, 2, 2, 2, 1, 1, 1, 2, 2, 2, 2, 2, 2, 2, 2, 2, 1, 1, 1, 2, 2, 2, 2, 2],
          [2, 2, 1, 2, 2, 2, 1, 1, 1, 2, 2, 2, 2, 2, 2, 2, 1, 1, 1, 2, 2, 2, 1, 2, 2],
          [2, 1, 1, 1, 2, 2, 2, 1, 1, 1, 8, 2, 2, 2, 8, 1, 1, 1, 2, 2, 2, 1, 1, 1, 2],
          [2, 2, 1, 2, 2, 2, 2, 2, 1, 1, 1, 2, 2, 2, 1, 1, 1, 2, 2, 2, 2, 2, 1, 2, 2],
          [2, 2, 2, 2, 2, 2, 2, 2, 8, 1, 1, 1, 3, 1, 1, 1, 8, 2, 2, 2, 2, 2, 2, 2, 2],
          [2, 5, 5, 5, 2, 2, 2, 2, 2, 2, 1, 1, 1, 1, 1, 2, 2, 2, 2, 2, 2, 5, 5, 5, 2],
          [2, 5, 8, 5, 2, 2, 2, 2, 2, 2, 6, 1, 1, 1, 7, 2, 2, 2, 2, 2, 2, 5, 8, 5, 2],
          [2, 5, 5, 5, 2, 2, 2, 2, 2, 2, 1, 1, 1, 1, 1, 2, 2, 2, 2, 2, 2, 5, 5, 5, 2],
          [2, 2, 2, 2, 2, 2, 2, 2, 8, 1, 1, 1, 4, 1, 1, 1, 8, 2, 2, 2, 2, 2, 2, 2, 2],
          [2, 2, 1, 2, 2, 2, 2, 2, 1, 1, 1, 2, 2, 2, 1, 1, 1, 2, 2, 2, 2, 2, 1, 2, 2],
          [2, 1, 1, 1, 2, 2, 2, 1, 1, 1, 8, 2, 2, 2, 8, 1, 1, 1, 2, 2, 2, 1, 1, 1, 2],
          [2, 2, 1, 2, 2, 2, 1, 1, 1, 2, 2, 2, 2, 2, 2, 2, 1, 1, 1, 2, 2, 2, 1, 2, 2],
          [2, 2, 2, 2, 2, 1, 1, 1, 2, 2, 2, 2, 2, 2, 2, 2, 2, 1, 1, 1, 2, 2, 2, 2, 2],
          [2, 2, 2, 2, 2, 2, 1, 2, 2, 2, 2, 2, 2, 2, 2, 2, 2, 2, 1, 2, 2, 2, 2, 2, 2],
          [2, 2, 2, 1, 2, 2, 2, 2, 2, 2, 2, 2, 2, 2, 2, 2, 2, 2, 2, 2, 2, 1, 2, 2, 2],
          [2, 2, 1, 1, 1, 2, 2, 2, 1, 2, 2, 5, 5, 5, 2, 2, 1, 2, 2, 2, 1, 1, 1, 2, 2],
          [2, 1, 1, 1, 2, 2, 2, 1, 1, 1, 2, 5, 8, 5, 2, 1, 1, 1, 2, 2, 2, 1, 1, 1, 2],
          [1, 1, 1, 2, 2, 2, 2, 2, 1, 2, 2, 5, 5, 5, 2, 2, 1, 2, 2, 2, 2, 2, 1, 1, 1],
          [1, 1, 2, 2, 2, 2, 2, 2, 2, 2, 2, 2, 2, 2, 2, 2, 2, 2, 2, 2, 2, 2, 2, 1, 1]],
    "energy": {
        "(12, 2)": 40,
        "(10, 8)": 10,
        "(14, 8)": 10,
        "(8, 10)": 10,
        "(16, 10)": 10,
        "(2, 12)": 40,
        "(22, 12)": 40,
        "(8, 14)": 10,
        "(16, 14)": 10,
        "(10, 16)": 10,
        "(14, 16)": 10,
        "(12, 22)": 40
    }
}